___________________________
___________________________
______1___1___1___1___1____
___________________________
________1___1___1___1______
___________________________
______1___1___1___1___1____
___________________________
________1___1___1___1______
___________________________
___________________________
___________________________
___________________________
___________________________
___________________________
___________________________
___________________________
___________________________
___________________________
___________________________
____BBB_____BBB_____BBB____
___BBBBB___BBBBB___BBBBB___
___________________________
___________________________
___________________________
___________________________
___________________________