___________________________
___________________________
______1_1_1_1_1_1_1_1_1____
___________________________
______1_1_1_1_1_1_1_1_1____
___________________________
______1_1_1_1_1_1_1_1_1____
___________________________
______1_1_1_1_1_1_1_1_1____
___________________________
___________________________
___________________________
___________________________
___________________________
___________________________
___________________________
___________________________
___________________________
___________________________
___________________________
__BB__BB__BB__BB__BB__BB___
___________________________
___________________________
___________________________
___________________________
___________________________
___________________________